width: 40
height: 15
---
xxxxxxxxxxxxxxxxxxxxxxxxxxxxxxxxxxxxxxxx
x  *               S     x             x
x      o o       v       x    *   *    x
x                      * x     o       x
x         s        xxxxxxx            sx
x     xxx *   xx    o                  x
x       o                     xxx      x
x            xxxxxxxxxx        x       x
x         *                    x   *   x
x      S              S     *  x       x
x  *      o      *                     x
x         o                      o     x
x     xx     s        xs               x
x  P      *           x       *        x
xxxxxxxxxxxxxxxxxxxxxxxxxxxxxxxxxxxxxxxx
---
